#######
#   T #
#  GZ #
#   C #
#P    #
#     #
#    H#
#######